111111111111111111
100111110001001001
110000C00010010001
101001C0001C001001
1000C01C0000000111
1111010C0111100001
100101001C010C1001
10PC010100000001E1
111111111111111111