111111111111111111
1P0111110010000001
100001000C001C0011
1C011C000111000C01
100000111000111001
111C010000C0011001
100010011111010C01
1C0000000000E00011
111111111111111111