111111111111111111
1P0001100101000001
111C011000010C1101
100011110110001001
1C0000000100010C11
111011110111011001
1000100000000100C1
1C01111111111001E1
111111111111111111