111111111111111111
1PCCC11CC111CCCCE1
111CC11CCCCCCC11C1
1CCC1111C11CCC1CC1
1CCCCCCCC1CCC1CC11
111C1111C111C11CC1
1CCC1CCCCC11C1CCC1
1CC111111111CCC1C1
111111111111111111