1111111111111111111111111111111111
1C0000000000000C00000C000000011101
1E00010100100000101001000000000001
1000010010101010001001000000010101
1P1000000C00C000000000000000010101
1010010100100100101001000000010101
1010010010101010001001000000010101
10100000C00C0000000000000000010101
1010010100100000101001000000010101
1010010010101010001001000000010101
1111111111111111111101111111111111
1000000000000000000010000000000001
1111111111111111111111111111111111