111111111
1P0111111
100000C01
101001C01
1000C01C1
10C1010C1
1001011E1
100011011
111111111